1,1,1,1,1,1,1,1,1,1,1,1,1,1,1,1,1,1,1,1
1,0,0,0,5,0,0,0,1,0,0,0,1,1,3,1,0,0,0,1
1,1,1,1,1,1,1,0,1,0,9,0,1,1,0,1,0,0,0,1
1,0,0,0,0,0,1,0,1,0,0,0,1,1,0,1,0,0,0,1
1,0,0,0,1,4,1,0,1,0,0,0,1,0,0,0,0,0,0,1
1,0,0,0,1,0,1,0,1,0,0,0,1,0,0,0,0,0,0,1
1,0,0,0,1,0,1,0,1,0,0,0,1,0,0,0,0,0,0,1
1,0,0,0,1,0,1,0,1,0,0,0,1,0,0,0,0,0,0,1
1,0,0,0,1,0,1,0,1,4,4,4,1,0,0,0,0,0,0,1
1,1,0,0,1,0,1,0,1,0,0,0,1,0,0,0,0,0,0,1
1,0,0,0,1,0,0,0,1,8,0,0,1,0,0,0,0,0,0,1
1,0,0,0,1,0,1,1,1,1,1,1,1,0,0,0,0,0,0,1
1,0,0,0,1,0,1,3,0,1,0,0,0,0,0,0,0,0,0,1
1,0,0,0,1,0,1,0,0,1,0,0,0,0,0,0,0,0,0,1
1,0,0,0,1,0,0,0,0,1,0,0,0,0,0,0,0,0,0,1
1,1,0,0,1,1,1,1,1,1,0,0,0,0,0,0,0,0,0,1
1,0,0,0,0,0,0,0,0,0,0,0,0,0,0,1,1,1,1,1
1,0,0,0,0,0,0,0,0,0,0,0,0,0,1,0,1,1,1,1
1,0,0,0,0,0,0,0,0,0,0,0,0,0,0,0,1,1,1,1
1,1,1,1,1,1,1,1,1,1,1,1,1,1,1,1,1,1,1,1