1,1,1,1,1,1,2,2,2,2,2,2,2,2,1,1,1,1,1,1
1,3,1,0,0,1,0,0,0,0,0,0,0,0,1,0,0,0,0,1
1,0,1,0,6,1,0,0,0,0,0,0,0,0,1,6,0,1,0,1
1,0,4,0,1,1,0,0,0,4,4,0,9,0,1,1,1,4,0,1
1,0,0,0,0,1,4,0,0,1,1,0,0,0,1,3,0,0,0,1
1,1,1,1,1,1,4,0,0,1,1,1,1,1,1,1,1,1,1,1
2,0,0,0,0,0,0,0,0,0,0,0,0,0,0,0,0,0,0,2
2,0,0,0,0,0,0,5,5,5,5,5,5,0,0,0,0,1,0,2
2,0,0,0,0,1,0,5,5,5,5,5,5,0,1,0,0,1,0,2
2,0,0,0,0,1,0,5,5,5,5,5,5,0,1,0,0,0,0,2
2,0,0,0,0,1,0,5,5,5,5,5,5,0,1,0,0,0,0,2
2,0,0,0,0,1,0,5,5,5,5,5,5,0,1,0,0,1,0,2
2,0,0,0,0,0,0,5,5,5,5,5,5,0,0,0,0,1,0,2
2,0,0,0,0,0,0,0,0,0,0,0,0,0,0,0,0,0,0,2
1,1,1,1,1,1,0,0,0,1,1,0,0,0,1,1,1,1,1,1
1,0,0,0,0,1,0,0,0,0,0,0,0,0,1,0,0,0,0,1
1,0,0,0,0,1,0,0,0,0,0,0,0,0,1,4,0,1,0,1
1,0,0,0,3,1,0,0,0,0,0,0,0,0,1,1,0,1,0,1
1,0,0,0,0,1,0,0,0,0,0,0,0,0,1,1,3,1,0,1
1,1,1,1,1,1,2,2,2,2,2,2,2,2,1,1,1,1,1,1